1000
14 27
###########################
#                         #
#r C C C C C C C C C C C R#
#   P P P P P P P P P P   #
# $  C C C C C C C C C  $ #
# #   P P P P P P P P   # #
# #                     # #
# ####################### #
# # C C C C C C C C C C # #
# #  C C C C C C C C C  # #
# #$  P P P P P P P P  $# #
# #########     ######### #
#                         #
###########################

