1000
14 14
##############
#$PCCCCCCCCP$#
##############
#            #
#            #
#            #
#    PCCP    #
#r   C##C   R#
#    P##P    #
#    CPPC    #
#$          $#
#            #
#P          P#
##############