1000
14 14
##############
#$#P      P#$#
#     rR     #
#            #
#C    CC    C#
###        ###
#C          C#
##############
#P  C#  #C  P#
#$# C#CC#C #$#
##############
#$P C CC C P$#
#C   P  P   C#
##############